################################
#..............................#
#..............................#
#..............................#
#..............................#
#.......#####..................#
#.......#...#..................#
#.......#...#..................#
#...#####...###############....#
#...#.....................#....#
#...#......####...........#....#
#...#...####..#...........#....#
#...#.........#...........#....#
#...########..#############..e.#
#...#.....................#....#
#...##############..#######....#
#................#..#..........#
#..............###..#..........#
#..............#....#..........#
#..............................#
#....p.........................#
#..............................#
#.................e............#
#..............................#
#..............................#
#.......#...#..................#
#.......#...#..................#
#...#####...###############....#
#...#.....................#....#
#...#......####...........#....#
#...#...####..#...........#....#
#...#.........#...........#....#
#...########..#############....#
#...#.....................#....#
#...#######################....#
#..............................#
#..............................#
#..............................#
#..............................#
################################
